22 39 25
   ########
  ##  .#  #
 ### #  $ #
#### $ # .#
#  $ . ## #
#   ####  #
# @ ###   #
###########
