39 16
  ##########
###  #     #
##   *     #
#       #  #
##     #   #
#$ #  +  ##
# #      #
#########
