19 15 82
###########
####  .#  #
 ### # $. #
####  $#  #
#@$.   ## #
#   ###   #
#   ###   #
###########
