27 63 61 65
###  ####
#  ## # #
#  #    #
#   $ . #
#     $ #
#. #    #
#       #
#    #$ ##
 #  .@ * ##
##########
