39 16
 ############
##   #      #
##   *      #
#       #   #
##     #    #
#$ #  +   ##
# #      ###
##########
