2 59 2 77 89
   ####  
  ##  ###
###. @$ #
# $$    #
# .   ###
##..$.##
 #$  ##
 #  ##
 #####