62 14
#######  ######
#    ## #     #
# #    #     ##
# ## +    ##  #
#             #
# $     $   ##
 ##       #   #
  ##   #  . ###
   #### ##### ##
