49 70 23
  #########
####   #  #
 ###$# @  #
####   #  #
# ..$  ## #
#   ###.$ #
#   ###   #
###########