48 21
######## 
#  #   ##
##    # #
#     $ #
#  $    #
#      ##
#    .# #
# @#    #
#   # # #
#  # .  #
#########
