62 14
######    ######
#    ##  #     #
# #    ##    ##
# ## + #  ##  #
#     ###     #
# $   # $   ##
 ##       #   #
  ##   #  . ###
   #### ##### 

