12 29
  ######
  # ..@#
  # $$ #
  ## ###
   # #  
   # #  
#### #  
#    ## 
# #   # 
#   # # 
###   # 
  ##### 