75 50 31
  ### ##
###  #  ##
#   # $  #
# *     .#
#     #  #
#     #  #
#+   ##  #
#       ##
#      #
#   $   ##
#  ###   #
###   ####
