2 99 56 23
 ##########
  ##   #  #
####@#$  .#
####$  #  #
#  .  .## #
# $ ### $ #
#  .###   #
###########