96 65 74 53 52 56
      #####     
    ##  . #     
 ###    $ #     
   #      #     
###     *  ###
# ##     $ * #  
#    . $  +  #  
#            #
#  #.$    #  #
#         #  #
##############