7
##############
# #          #
#  $         #
#       #    #
#      @     #
#    .       #
#            #
#            #
##############
