12 23 86 23 23
   #####  
   # #*#  
  #.#  ## 
### #    ###
##   $ $*# #
#   ### @ ##
##   #   ###
  #   $ #
  # . #.#
  #######
