57 43 63
############
# #     ## #
#   ..$  # #
#  $@##    #
#  .    ## #
#    #     #
# $    #   #
###        #
 ###########
