15 61 63 97
   #######     
  #  #   #     
  #   ## #     
  #$  $  #     
##  +     #####
#             #
#        .  $.#
#        *    #
###############
