10 8 35
 ##########
  ##  .# .#
#### #  $ #
#### $ #  #
# @ .  ## #
# $ ###   #
#   ###   #
###########
