44 36 84
###########
 ###  .#  #
  ## #  $ #
#### $ # .#
#  $ . ## #
#   ###   #
# @ ###   #
###########
