10 11 1 5 97 63 86
    ####
  ###  ###
  #  $ . #
 ##$#   $#
 #      .##
 # $$   @ #
 ##$.  .  #
##  #   .##
##  .#.$ #
#######  #
     #####